111111111111111111111111111111111111111111
1C011000000000000000000000000000C000000001
100000011000011111110000111111100000001101
100011011000000000010000000000100001101101
100110011000000000010000000000100011001101
100000011000011111110000111111100000001101
1000C0011000000000010000000000100000001101
100000011000P00000010000000E00100000001101
10000001100000000001000000000010000C001101
100000011000011111110000111111100000001101
100000000000000000000000000000000110000001
1000110000C00000000000000000000000000C0001
111111111111111111111111111111111111111111