11111111111111111111
100C0000C000010001C1
10001001100100100101
100C1100E00001000001
1C000000100000001001
11111111111111111111