11111111111111111111
1P000000000001000101
10001001100100100101
10001100E00001000001
10000000100000001001
11111111111111111111