1111111
1000001
1PC0E11
1111111