111111111
101000C01
11P100001
100000E01
10C000001
111111111