1111111111111111111111111111111111
10000000C000000C00000C000000000001
10100101001000001010010000000101E1
1010010010101011001001000000010101
1P000C000C00C000C000000000000000C1
1111111111111111111111111111111111